{
    "name": "Basics",
    "author": "Maggie",
    "source": null,
    "levels": [
      [
        "#############################",
        "#   #          #            #",
        "#    #   ##########    ######",
        "#    #           #     # #  #",
        "#  #######   #  ######## #  #",
        "#   #  #     #     #   #    #",
        "#      #  #######  #   #    #",
        "#  #   #  #  1  #  #   #    #",
        "#  #####     x     #        #",
        "#      #  #     #  #   #    #",
        "#      #  #######  #   #    #",
        "#      #           #####    #",
        "#####    #   #         #    #",
        "#    #####   #####  #     # #",
        "#    #       # @    #     # #",
        "#############################"
      ],
      [
        "#############################",
        "# /                         #",
        "#        1    2    3        #",
        "#                           #",
        "###                       ###",
        "####     x    y    z     ####",
        "#######               #######",
        "#######               #######",
        "#######               #######",
        "#                           #",
        "#                           #",
        "#######               #######",
        "#######               #######",
        "########      @      ########",
        "##########         ##########",
        "#############################"
      ]
    ]
}