{
    "name": "Constant Function (Bool 1)",
    "author": "Maggie",
    "source": null,
    "levels": [
        [
            "#############################",
            "#                           #",
            "#      (/ 1 (/ 2  1 )       #",
            "#          .    .           #",
            "#                           #",
            "#                           #",
            "#    #############      #####",
            "#        #                  #",
            "#        #             x    #",
            "#        #                  #",
            "#   #########       #########",
            "#       #                   #",
            "#   y   #   x       #       #",
            "#       #           #   @   #",
            "#       #           #       #",
            "#############################"
          ],
          [
            "#############################",
            "#                           #",
            "#    (/ x (/ y  x ) ### T   #",
            "#        .     .            #",
            "#                           #",
            "#                           #",
            "#    #############      #####",
            "#        #                  #",
            "#        #                  #",
            "#        #                  #",
            "#   #########       #########",
            "#       #                   #",
            "#       #           #       #",
            "#       #           #   @   #",
            "#       #           #       #",
            "#############################"
          ]
    ]
}