{
    "name": "Constant Function (Bool 2)",
    "author": "Maggie",
    "source": null,
    "levels": [
        [
            "#############################",
            "#########           #########",
            "########      x      ########",
            "####### (/1 (/2  2 )) #######",
            "######     .   .       ######",
            "#####                   #####",
            "####                     ####",
            "###                       ###",
            "##    y              y     ##",
            "###                       ###",
            "####          @          ####",
            "######                  #####",
            "#######                ######",
            "########              #######",
            "#########            ########",
            "#############################"
          ],
          [
            "#############################",
            "#########           #########",
            "########             ########",
            "####### (/x (/y  y )) #######",
            "######     .   .       ######",
            "#####        ###        #####",
            "####                     ####",
            "###           F           ###",
            "##                         ##",
            "###                       ###",
            "####          @          ####",
            "######                  #####",
            "#######                ######",
            "########              #######",
            "#########            ########",
            "#############################"
          ]
    ]
}