{
    "name": "Conditional",
    "author": "Maggie",
    "source": null,
    "levels": [
      [
        "#############################",
        "####     ###     ###     ####",
        "# #       #       #    x  # #",
        "#                           #",
        "# (/1 (/2 (/3 ((1 3 ) 2 ))) #",
        "#    .   .   .              #",
        "#                           #",
        "########      ###############",
        "#    ###      ##    ###     #",
        "# z         ####    ###  z  #",
        "#                   ###     #",
        "#########     @ y   ###     #",
        "#     ########       ##     #",
        "#  x                     y  #",
        "#        ###    ###         #",
        "#############################"
      ],
      [
        "#############################",
        "####     ###     ###     ####",
        "# #   T   #   f   #   F   # #",
        "#                           #",
        "# (/x (/y (/z ((x z ) y ))) #",
        "#    .   .   .              #",
        "#                           #",
        "########      ###############",
        "#    ###      ##    ###     #",
        "#           ####    ###     #",
        "#                   ###     #",
        "#########     @     ###     #",
        "#     ########       ##     #",
        "#                           #",
        "#        ###    ###         #",
        "#############################"
      ]
    ]
}