{
    "name": "Circle",
    "author": "Maggie",
    "source": null,
    "levels": [
        [
            "#############################",
            "####      ########       ####",
            "###     ##        ##      ###",
            "##    ## (/1  1 1 ) ##     ##",
            "#    #      .         #     #",
            "#   #              x   #    #",
            "#   #                  #    #",
            "#  #    x               #   #",
            "#  #                    #   #",
            "#   #                  #    #",
            "#   #                  #    #",
            "#    #       @        #     #",
            "##    ##        x   ##     ##",
            "###     ##        ##      ###",
            "####      ########       ####",
            "#############################"
          ],
          [
            "#############################",
            "####      ########       ####",
            "###     ##        ##      ###",
            "##    ##(/x  x x )z ##     ##",
            "#    #      .         #     #",
            "#   #       ####       #    #",
            "#   #                  #    #",
            "#  #       (z z )       #   #",
            "#  #                    #   #",
            "#   #                  #    #",
            "#   #                  #    #",
            "#    #       @        #     #",
            "##    ##            ##     ##",
            "###     ##        ##      ###",
            "####      ########       ####",
            "#############################"
          ]
    ]
}