{
    "name": "Y Combinator",
    "author": "Maggie",
    "source": null,
    "levels": [
        [
            "###################################",
            "#                                 #",
            "#/f  (/1  f (1 1 )) (/1  f (1 1 ))#",
            "#  .    .              .          #",
            "#                                 #",
            "##     #                   #     ##",
            "# #     #                 #     # #",
            "#  #     #   x       x   #     #  #",
            "#   #   # #             # #   #   #",
            "#    ###   #   # @ #   #   ###    #",
            "#     #     ###     ###     #     #",
            "#  x  #  x   #       #   x  #  x  #",
            "#     #      #       #      #     #",
            "#                                 #",
            "#                                 #",
            "###################################"
          ],
          [
            "###################################",
            "#                                 #",
            "#/f  (/x  f (x x )) (/x  f (x x ))#",
            "#  .    .              .          #",
            "#            ###   ###            #",
            "#     #     #   # #   #     #     #",
            "##     #   #     #     #   #     ##",
            "# #     #   #   # #   #   #     # #",
            "#  #     #   ###   ###   #     #  #",
            "#   #   # #             # #   #   #",
            "#    ###   #           #   ###    #",
            "#     #     ###  @  ###     #     #",
            "#     #      #       #      #     #",
            "#     #      #       #      #     #",
            "#                                 #",
            "###################################"
          ]
    ]
}