{
    "name": "And, Or, & Not",
    "author": "Maggie",
    "source": null,
    "levels": [
        [
            "#############################",
            "#                           #",
            "#    (/1 (/2 ((1 2 )F )))   #",
            "#   .   .                   #",
            "#                           #",
            "#                           #",
            "##################          #",
            "#                           #",
            "#     x       #       y     #",
            "#             #             #",
            "#   #########################",
            "#                           #",
            "#   y            x          #",
            "#       #               @   #",
            "#       #                   #",
            "#############################"
          ],
          [
            "#############################",
            "#                           #",
            "#(/x (/y ((x y )F ))) ## A  #",
            "#   .   .                   #",
            "#                           #",
            "#                           #",
            "##################          #",
            "#                           #",
            "#             #             #",
            "#             #             #",
            "#   #########################",
            "#                           #",
            "#                           #",
            "#       #               @   #",
            "#       #                   #",
            "#############################"
          ],
          [
            "#############################",
            "#                           #",
            "#   (/1 (/2 ((1 T )2 )))    #",
            "#   .   .                   #",
            "#                           #",
            "#                           #",
            "#       ###### ######       #",
            "#   x   #           #   y   #",
            "#       #           #       #",
            "#       #           #       #",
            "#       #           #       #",
            "#       #           #       #",
            "#   x   #           #   y   #",
            "#       #     @     #       #",
            "#       #           #       #",
            "#############################"
          ],
          [
            "#############################",
            "#                           #",
            "#(/x (/y ((x T )y ))) ## O  #",
            "#   .   .                   #",
            "#                           #",
            "#                           #",
            "#       ###### ######       #",
            "#       #           #       #",
            "#       #           #       #",
            "#       #           #       #",
            "#       #           #       #",
            "#       #           #       #",
            "#       #           #       #",
            "#       #     @     #       #",
            "#       #           #       #",
            "#############################"
          ],
          [
            "#############################",
            "#                           #",
            "#     (/1.((1 F ) T ))      #",
            "#                           #",
            "#                           #",
            "#                           #",
            "##############              #",
            "#   x   #       #####   x   #",
            "#       #           #       #",
            "#       ########    #       #",
            "#       #           #       #",
            "#       #   #########       #",
            "#   x   #           #   x   #",
            "#       #     @     #       #",
            "#       #           #       #",
            "#############################"
          ],
          [
            "#############################",
            "#                           #",
            "#   (/x.((x F ) T )) ## N   #",
            "#                           #",
            "#                           #",
            "#                           #",
            "##############              #",
            "#   x   #       #####       #",
            "#       #           #       #",
            "#       ########    #       #",
            "#       #           #       #",
            "#       #   #########       #",
            "#   x   #           #       #",
            "#       #     @     #       #",
            "#       #           #       #",
            "#############################"
          ]
    ]
}