{
    "name": "Beta Reduction #3",
    "author": "Maggie",
    "source": null,
    "levels": [
          [
            "###################################",
            "#                                 #",
            "#   ((O((A T ) F ))((A T ) T ))   #",
            "#                                 #",
            "#                                 #",
            "#                                 #",
            "#                                 #",
            "#                                 #",
            "#                                 #",
            "#                                 #",
            "#                                 #",
            "#                                 #",
            "#                                 #",
            "#                                 #",
            "#                                 #",
            "#                                 #",
            "#                                 #",
            "#                   @             #",
            "###################################"
          ],
          [
            "###################################",
            "#                                 #",
            "#   ((O((A T ) F ))((A T ) T ))   #",
            "#     O (A T F )    (A T T )      #",
            "#(/1  /2  1 1 2 ) (A T F )(A T T )#",
            "#  x.  y. x x y                   #",
            "#                                 #",
            "#                                 #",
            "#                                 #",
            "#                                 #",
            "#                                 #",
            "#                                 #",
            "#                                 #",
            "#                                 #",
            "#                                 #",
            "#                                 #",
            "#                                 #",
            "#                   @             #",
            "###################################"
          ],
          [
            "###################################",
            "#                                 #",
            "#   ((O((A T ) F ))((A T ) T ))   #",
            "#     O (A T F )    (A T T )      #",
            "#(/x  /y  x x y ) (A T F )(A T T )#",
            "#   .   .                         #",
            "#      A T F (A T F ) (A T T)     #",
            "#                                 #",
            "#                                 #",
            "#                                 #",
            "#                                 #",
            "#                                 #",
            "#                                 #",
            "#                                 #",
            "#                                 #",
            "#                                 #",
            "#                                 #",
            "#                   @             #",
            "###################################"
          ],
          [
            "###################################",
            "#                                 #",
            "#   ((O((A T ) F ))((A T ) T ))   #",
            "#     O (A T F )    (A T T )      #",
            "#(/x  /y  x x y ) (A T F )(A T T )#",
            "#   .   .                         #",
            "#      A T F (A T F ) (A T T )    #",
            "#(/1 /2 1 2 1 )T F(A T F )(A T T )#",
            "#  x. y.x y x                     #",
            "#                                 #",
            "#                                 #",
            "#                                 #",
            "#                                 #",
            "#                                 #",
            "#                                 #",
            "#                                 #",
            "#                                 #",
            "#                   @             #",
            "###################################"
          ],
          [
            "###################################",
            "#                                 #",
            "#   ((O((A T ) F ))((A T ) T ))   #",
            "#     O (A T F )    (A T T )      #",
            "#(/x  /y  x x y ) (A T F )(A T T )#",
            "#   .   .                         #",
            "#      A T F (A T F ) (A T T )    #",
            "#(/x /y x y x )T F(A T F )(A T T )#",
            "#   .  .                          #",
            "# (/2 T 2 T ) F (A T F )(A T T )  #",
            "#   y.  y                         #",
            "#                                 #",
            "#                                 #",
            "#                                 #",
            "#                                 #",
            "#                                 #",
            "#                                 #",
            "#                   @             #",
            "###################################"
          ],
          [
            "###################################",
            "#                                 #",
            "#   ((O((A T ) F ))((A T ) T ))   #",
            "#     O (A T F )    (A T T )      #",
            "#(/x  /y  x x y ) (A T F )(A T T )#",
            "#   .   .                         #",
            "#      A T F (A T F ) (A T T )    #",
            "#(/x /y x y x )T F(A T F )(A T T )#",
            "#   .  .                          #",
            "# (/y T y T ) F (A T F )(A T T )  #",
            "#    .                            #",
            "#      T F T (A T F ) (A T T )    #",
            "#                                 #",
            "#                                 #",
            "#                                 #",
            "#                                 #",
            "#                                 #",
            "#                   @             #",
            "###################################"
          ],
          [
            "###################################",
            "#                                 #",
            "#   ((O((A T ) F ))((A T ) T ))   #",
            "#     O (A T F )    (A T T )      #",
            "#(/x  /y  x x y ) (A T F )(A T T )#",
            "#   .   .                         #",
            "#      A T F (A T F ) (A T T )    #",
            "#(/x /y x y x )T F(A T F )(A T T )#",
            "#   .  .                          #",
            "# (/y T y T ) F (A T F )(A T T )  #",
            "#    .                            #",
            "#      T F T (A T F ) (A T T )    #",
            "# (/1 /2 1) F T (A T F ) (A T T ) #",
            "#   x. y.x                        #",
            "#                                 #",
            "#                                 #",
            "#                                 #",
            "#                   @             #",
            "###################################"
          ],
          [
            "###################################",
            "#                                 #",
            "#   ((O((A T ) F ))((A T ) T ))   #",
            "#     O (A T F )    (A T T )      #",
            "#(/x  /y  x x y ) (A T F )(A T T )#",
            "#   .   .                         #",
            "#      A T F (A T F ) (A T T )    #",
            "#(/x /y x y x )T F(A T F )(A T T )#",
            "#   .  .                          #",
            "# (/y T y T ) F (A T F )(A T T )  #",
            "#    .                            #",
            "#      T F T (A T F ) (A T T )    #",
            "# (/x /y x) F T (A T F ) (A T T ) #",
            "#    .  .                         #",
            "#   (/2 F ) T (A T F ) (A T T )   #",
            "#     y.                          #",
            "#                                 #",
            "#                   @             #",
            "###################################"
          ],
          [
            "###################################",
            "#                                 #",
            "#   ((O((A T ) F ))((A T ) T ))   #",
            "#     O (A T F )    (A T T )      #",
            "#(/x  /y  x x y ) (A T F )(A T T )#",
            "#   .   .                         #",
            "#      A T F (A T F ) (A T T )    #",
            "#(/x /y x y x )T F(A T F )(A T T )#",
            "#   .  .                          #",
            "# (/y T y T ) F (A T F )(A T T )  #",
            "#    .                            #",
            "#      T F T (A T F ) (A T T )    #",
            "# (/x /y x) F T (A T F ) (A T T ) #",
            "#    .  .                         #",
            "#   (/y F ) T (A T F ) (A T T )   #",
            "#      .                          #",
            "#       F (A T F ) (A T T )       #",
            "#                   @             #",
            "###################################"
          ],
          [
            "###################################",
            "#                                 #",
            "#       F (A T F ) (A T T )       #",
            "#   (/1 /2 2 )(A T F )(A T T )    #",
            "#     x. y.y                      #",
            "#                                 #",
            "#                                 #",
            "#                                 #",
            "#                                 #",
            "#                                 #",
            "#                                 #",
            "#                                 #",
            "#                                 #",
            "#                                 #",
            "#                                 #",
            "#                                 #",
            "#                                 #",
            "#                   @             #",
            "###################################"
          ],
          [
            "###################################",
            "#                                 #",
            "#       F (A T F ) (A T T )       #",
            "#   (/x /y y )(A T F )(A T T )    #",
            "#      .  .                       #",
            "#        (/2 2 ) (A T T )         #",
            "#           y.y                   #",
            "#                                 #",
            "#                                 #",
            "#                                 #",
            "#                                 #",
            "#                                 #",
            "#                                 #",
            "#                                 #",
            "#                                 #",
            "#                                 #",
            "#                                 #",
            "#                   @             #",
            "###################################"
          ],
          [
            "###################################",
            "#                                 #",
            "#       F (A T F ) (A T T )       #",
            "#   (/x /y y )(A T F )(A T T )    #",
            "#      .  .                       #",
            "#        (/y y ) (A T T )         #",
            "#            .                    #",
            "#             (A T T )            #",
            "#                                 #",
            "#                                 #",
            "#                                 #",
            "#                                 #",
            "#                                 #",
            "#                                 #",
            "#                                 #",
            "#                                 #",
            "#                                 #",
            "#                   @             #",
            "###################################"
          ],
          [
            "###################################",
            "#                                 #",
            "#       F (A T F ) (A T T )       #",
            "#   (/x /y y )(A T F )(A T T )    #",
            "#      .  .                       #",
            "#        (/y y ) (A T T )         #",
            "#            .                    #",
            "#             (A T T )            #",
            "#       (/1 /2 1 2 1 ) T T        #",
            "#         x. y.x y x              #",
            "#                                 #",
            "#                                 #",
            "#                                 #",
            "#                                 #",
            "#                                 #",
            "#                                 #",
            "#                                 #",
            "#                   @             #",
            "###################################"
          ],
          [
            "###################################",
            "#                                 #",
            "#       F (A T F ) (A T T )       #",
            "#   (/x /y y )(A T F )(A T T )    #",
            "#      .  .                       #",
            "#        (/y y ) (A T T )         #",
            "#            .                    #",
            "#             (A T T )            #",
            "#       (/x /y x y x ) T T        #",
            "#          .  .                   #",
            "#          (/2 T 2 T ) T          #",
            "#            y.  y                #",
            "#                                 #",
            "#                                 #",
            "#                                 #",
            "#                                 #",
            "#                                 #",
            "#                   @             #",
            "###################################"
          ],
          [
            "###################################",
            "#                                 #",
            "#       F (A T F ) (A T T )       #",
            "#   (/x /y y )(A T F )(A T T )    #",
            "#      .  .                       #",
            "#        (/y y ) (A T T )         #",
            "#            .                    #",
            "#             (A T T )            #",
            "#       (/x /y x y x ) T T        #",
            "#          .  .                   #",
            "#          (/y T y T ) T          #",
            "#             .                   #",
            "#              T T T              #",
            "#                                 #",
            "#                                 #",
            "#                                 #",
            "#                                 #",
            "#                   @             #",
            "###################################"
          ],
          [
            "###################################",
            "#                                 #",
            "#       F (A T F ) (A T T )       #",
            "#   (/x /y y )(A T F )(A T T )    #",
            "#      .  .                       #",
            "#        (/y y ) (A T T )         #",
            "#            .                    #",
            "#             (A T T )            #",
            "#       (/x /y x y x ) T T        #",
            "#          .  .                   #",
            "#          (/y T y T ) T          #",
            "#             .                   #",
            "#              T T T              #",
            "#         (/1 /2 1 ) T T          #",
            "#           x. y.x                #",
            "#                                 #",
            "#                                 #",
            "#                   @             #",
            "###################################"
          ],
          [
            "###################################",
            "#                                 #",
            "#       F (A T F ) (A T T )       #",
            "#   (/x /y y )(A T F )(A T T )    #",
            "#      .  .                       #",
            "#        (/y y ) (A T T )         #",
            "#            .                    #",
            "#             (A T T )            #",
            "#       (/x /y x y x ) T T        #",
            "#          .  .                   #",
            "#          (/y T y T ) T          #",
            "#             .                   #",
            "#              T T T              #",
            "#         (/x /y x ) T T          #",
            "#            .  .                 #",
            "#           (/2 T ) T             #",
            "#             y.                  #",
            "#                   @             #",
            "###################################"
          ],
          [
            "###################################",
            "#                                 #",
            "#       F (A T F ) (A T T )       #",
            "#   (/x /y y )(A T F )(A T T )    #",
            "#      .  .                       #",
            "#        (/y y ) (A T T )         #",
            "#            .                    #",
            "#             (A T T )            #",
            "#       (/x /y x y x ) T T        #",
            "#          .  .                   #",
            "#          (/y T y T ) T          #",
            "#             .                   #",
            "#              T T T              #",
            "#         (/x /y x ) T T          #",
            "#            .  .                 #",
            "#           (/y T ) T             #",
            "#              .                  #",
            "#               T   @             #",
            "###################################"
          ]
    ]
}