{
    "name": "Beta Reduction #1",
    "author": "Maggie",
    "source": null,
    "levels": [
      [
        "#############################",
        "####  ###    ###   ###   ####",
        "###    #      #     #     ###",
        "##                         ##",
        "# ((/1   /2   1 )(/1   1 )) #",
        "#    x .  y . x    x . x    #",
        "#                           #",
        "#                           #",
        "#                           #",
        "#             @             #",
        "##                         ##",
        "###    #      #     #     ###",
        "####  ###    ###   ###   ####",
        "#############################"
      ],
      [
        "#############################",
        "####  ###    ###   ###   ####",
        "###    #      #     #     ###",
        "#                           #",
        "# ((/x   /y   x )(/x   x )) #",
        "#      .    .        .      #",
        "#      (/2   (/1   1 )      #",
        "#         .     .           #",
        "#                           #",
        "#             @             #",
        "#                           #",
        "###    #      #     #     ###",
        "####  ###    ###   ###   ####",
        "#############################"
      ],
      [
        "#############################",
        "####  ###    ###   ###   ####",
        "###    #      #     #     ###",
        "#                           #",
        "# ((/x   /    x )(/      )) #",
        "#      .    .        .      #",
        "#      (/y   (/x   x )      #",
        "#         .     .           #",
        "#            ###            #",
        "#                           #",
        "#             F             #",
        "###    #      #     #     ###",
        "####  ###    ###   ###   ####",
        "#############################"
      ]
    ]
}