{
    "name": "Beta Reduction #3",
    "author": "Maggie",
    "source": null,
    "levels": [
        [
            "#############################",
            "#                           #",
            "#                           #",
            "#                           #",
            "#                           #",
            "#                           #",
            "#                           #",
            "#                           #",
            "#                           #",
            "#                           #",
            "#                           #",
            "#                           #",
            "#                           #",
            "#                           #",
            "#                           #",
            "#############################"
          ],
          [
            "#############################",
            "#                           #",
            "#                           #",
            "#                           #",
            "#                           #",
            "#                           #",
            "#                           #",
            "#                           #",
            "#                           #",
            "#                           #",
            "#                           #",
            "#                           #",
            "#                           #",
            "#                           #",
            "#                           #",
            "#############################"
          ],
          [
            "#############################",
            "#                           #",
            "#                           #",
            "#                           #",
            "#                           #",
            "#                           #",
            "#                           #",
            "#                           #",
            "#                           #",
            "#                           #",
            "#                           #",
            "#                           #",
            "#                           #",
            "#                           #",
            "#                           #",
            "#############################"
          ],
          [
            "#############################",
            "#                           #",
            "#                           #",
            "#                           #",
            "#                           #",
            "#                           #",
            "#                           #",
            "#                           #",
            "#                           #",
            "#                           #",
            "#                           #",
            "#                           #",
            "#                           #",
            "#                           #",
            "#                           #",
            "#############################"
          ],
          [
            "#############################",
            "#                           #",
            "#                           #",
            "#                           #",
            "#                           #",
            "#                           #",
            "#                           #",
            "#                           #",
            "#                           #",
            "#                           #",
            "#                           #",
            "#                           #",
            "#                           #",
            "#                           #",
            "#                           #",
            "#############################"
          ],
          [
            "#############################",
            "#                           #",
            "#                           #",
            "#                           #",
            "#                           #",
            "#                           #",
            "#                           #",
            "#                           #",
            "#                           #",
            "#                           #",
            "#                           #",
            "#                           #",
            "#                           #",
            "#                           #",
            "#                           #",
            "#############################"
          ],
          [
            "#############################",
            "#                           #",
            "#                           #",
            "#                           #",
            "#                           #",
            "#                           #",
            "#                           #",
            "#                           #",
            "#                           #",
            "#                           #",
            "#                           #",
            "#                           #",
            "#                           #",
            "#                           #",
            "#                           #",
            "#############################"
          ],
          [
            "#############################",
            "#                           #",
            "#                           #",
            "#                           #",
            "#                           #",
            "#                           #",
            "#                           #",
            "#                           #",
            "#                           #",
            "#                           #",
            "#                           #",
            "#                           #",
            "#                           #",
            "#                           #",
            "#                           #",
            "#############################"
          ],
          [
            "#############################",
            "#                           #",
            "#                           #",
            "#                           #",
            "#                           #",
            "#                           #",
            "#                           #",
            "#                           #",
            "#                           #",
            "#                           #",
            "#                           #",
            "#                           #",
            "#                           #",
            "#                           #",
            "#                           #",
            "#############################"
          ],
          [
            "#############################",
            "#                           #",
            "#                           #",
            "#                           #",
            "#                           #",
            "#                           #",
            "#                           #",
            "#                           #",
            "#                           #",
            "#                           #",
            "#                           #",
            "#                           #",
            "#                           #",
            "#                           #",
            "#                           #",
            "#############################"
          ]
    ]
}