{
    "name": "Beta Reduction #2",
    "author": "Maggie",
    "source": null,
    "levels": [
        [
            "###############################",
            "# ((/1  (1 1 )) (/1  (1 1 )) )#",
            "#    x.  x x      x.  x x     #",
            "#                             #",
            "#                             #",
            "#                             #",
            "#                             #",
            "#                             #",
            "#                             #",
            "#                             #",
            "#                             #",
            "#                             #",
            "#                             #",
            "#                             #",
            "##            @              ##",
            "###############################"
          ],
          [
            "###############################",
            "# ((/x  (x x )) (/x  (x x )) )#",
            "#     .            .          #",
            "# ((/1  (1 1 )) (/1  (1 1 )) )#",
            "#    x.  x x      x.  x x     #",
            "#                             #",
            "#                             #",
            "#                             #",
            "#                             #",
            "#                             #",
            "#                             #",
            "#                             #",
            "#                             #",
            "#                             #",
            "##            @              ##",
            "###############################"
          ],
          [
            "###############################",
            "# ((/x  (x x )) (/x  (x x )) )#",
            "#     .            .          #",
            "# ((/x  (x x )) (/x  (x x )) )#",
            "#     .            .          #",
            "# ((/1  (1 1 )) (/1  (1 1 )) )#",
            "#    x.  x x      x.  x x     #",
            "#                             #",
            "#                             #",
            "#                             #",
            "#                             #",
            "#                             #",
            "#                             #",
            "#                             #",
            "##            @              ##",
            "###############################"
          ],
          [
            "###############################",
            "# ((/x  (x x )) (/x  (x x )) )#",
            "#     .            .          #",
            "# ((/x  (x x )) (/x  (x x )) )#",
            "#     .            .          #",
            "# ((/x  (x x )) (/x  (x x )) )#",
            "#     .            .          #",
            "# ((/1  (1 1 )) (/1  (1 1 )) )#",
            "#    x.  x x      x.  x x     #",
            "#                             #",
            "#                             #",
            "#                             #",
            "#                             #",
            "#                             #",
            "##            @              ##",
            "###############################"
          ],
          [
            "###############################",
            "# ((/x  (x x )) (/x  (x x )) )#",
            "#     .            .          #",
            "# ((/x  (x x )) (/x  (x x )) )#",
            "#     .            .          #",
            "# ((/x  (x x )) (/x  (x x )) )#",
            "#     .            .          #",
            "# ((/x  (x x )) (/x  (x x )) )#",
            "#     .            .          #",
            "# ((/1  (1 1 )) (/1  (1 1 )) )#",
            "#    x.  x x      x.  x x     #",
            "#                             #",
            "#                             #",
            "#                             #",
            "##            @              ##",
            "###############################"
          ],
          [
            "###############################",
            "# ((/x  (x x )) (/x  (x x )) )#",
            "#     .            .          #",
            "# ((/x  (x x )) (/x  (x x )) )#",
            "#     .            .          #",
            "# ((/x  (x x )) (/x  (x x )) )#",
            "#     .            .          #",
            "# ((/x  (x x )) (/x  (x x )) )#",
            "#     .            .          #",
            "# ((/x  (x x )) (/x  (x x )) )#",
            "#     .            .          #",
            "# ((/1  (1 1 )) (/1  (1 1 )) )#",
            "#    x.  x x      x.  x x     #",
            "#                             #",
            "##            @              ##",
            "###############################"
          ],
          [
            "###############################",
            "# ((/x  (x x )) (/x  (x x )) )#",
            "#     .            .          #",
            "# ((/x  (x x )) (/x  (x x )) )#",
            "#     .            .          #",
            "# ((/x  (x x )) (/x  (x x )) )#",
            "#     .            .          #",
            "# ((/x  (x x )) (/x  (x x )) )#",
            "#     .            .          #",
            "# ((/x  (x x )) (/x  (x x )) )#",
            "#     .            .          #",
            "# ((/x  (x x )) (/x  (x x )) )#",
            "#     .            .          #",
            "# ((/1  (1 1 )) (/1  (1 1 )) )#",
            "##   x.  x x      x.  x x   # #",
            "###############################"
          ]
    ]
}